NO ./img/north1.xpm
SO ./img/south1.xpm
WE ./img/west1.xpm
EA ./img/east1.xpm

F 100,255,100
C 225,30,0


            111111111111111111111111111111111
111111111111101010101010101010101
100000000000000000000000000000001
100001111000000000000000000000001
100001  1000000000000000000000001
100001  1000000000000000000000001
100001  1000000000000000000000001
100001  10000100000000W0000000001
100001  1000000000000000000000001
100001  1000000000000000000000001
100001  1000000000000000000000001
100001  1000000000000000000000001
100001  1000000000000000000000001
100001  1000000000000000000000001
100001  1000000000000000000000001
100001  1000000000000000000000001
100001  1000000000000000000000001
100001  1000000000000000000000001
100001  1000000000000000000000001
100001  1000000000000000000000001
100001111000000000000000000000001
100000000000000000000000000000001
100000000000000000000000000000001
100000000000000000000000000000001
100000000000000000000000000000001
100000000000000000000000000000001
100000000000000000000000000000001
100000000000000000000000000000001
100000000000000000000000000000001
100000000000000000000000000000001
100000000000000000000000000000001
100000000000000000000000000000001
100000000000000000000000000000001
100000000000000000000000000000001
100000000000000000000000000000001
100000000000000000000000000000001
100000000000000000000000000000001
100000000000000000000000000000001
100000000000000000000000000000001
100000000000000000000000000000001
100000000000000000000000000000001
100000000000000000000000000000001
100000000000000000000000000000001
100000000000000000000000000000001
100000000000000000000000000000001
100000000000000000000000000000001
100000000000000000000000000000001
100000000000000000000000000000001
100000000000000000000000000000001
100000000000000000000000000000001
100000000000000000000000000000001
100000000000000000000000000000001
100000000000000000000000000000001
100000000000000000000000000000001
100000000000000000000000000000001
100000000000000000000000000000001
100000000000000000000000000000001
100000000000000000000000000000001
100000000000000000000000000000001
100000000000000000000000000000001
100000000000000000000000000000001
100000000000000000000000000000001
100000000000000000000000000000001
100000000000000000000000000000001
100000000000000000000000000000001
100000000000000000000000000000001
100000000000000000000000000000001
100000000000000000000000000000001
100000000000000000000000000000001
111111111111111111111111111111111
