   NO  ./img/north1.xpm
                     SO ./img/south1.xpm
WE                        ./img/west1.xpm
EA   ./img/east1.xpm

  F   100,255,100
C                  225,30,0

11111111111111111111111111111
10000000001100000000000000001
10110000011100000000000010001
10010000000000000000000010001
10110000011100000000000010011
10000000001100000111011110001
111111111111111011111111101111
11110111111111011101010010001
110001	101101010111000000101
10000111100000001100000010001
10000000000000001101010010001
10000000000111111111110000N01111111
110000001111	1	111101011110001
1111011111111111	111101111000111
111111111111111111111111011111111
100000000000000001100000010001
100000000000000000011010100111
11111111111111111111111111111