      111111111
      10000001
11111110000001
10000000000001
10000000000001
10000011110001
1000001  10001
10000011110001
10000000000001
11111111111111
