1111111111111
100S000000001
1000011110001
100001  10001
1000011110001
1000000000001
1111111111111
