   NO  ./img/north1.xpm
                     SO ./img/south1.xpm
WE                        ./img/west1.xpm
EA   ./img/east1.xpm

  F   100,255,100
C                  225,30,0

11111111111111
10000000000001
1000000000N001
11111111111111