      11111111111111111111111
      10000000000000000000001
11111110000000000000000000001
10000000000000000000000000001
10000000000000000000000000001
10000000000000000000000000001
100S0000000000000000000000001
10000000000000000000000000001
10000000000000000000000000001
10000000000000000000000000001
10000000000000000000000000001
10000000000000000000000000001
10000000000000000000000000001
10000000000000000000000000001
10000000000000000000000000001
10000000000000000000000000001
10000000000000000000000000001
10000000000000000000000000001
10000000000000000000000000001
10000000000000000000000000001
10000000000000000000000000001
10000000000000000000000000001
10000000000000000000000000001
10000000000000000000000000001
10000000000000000000000000001
10000000000000000000000000001
10000000000000000000000000001
10000000000000000000000000001
10000000000001111111111111111
10000011110001
1000001  10001
10000011110001
10000000000001
10000000000001
11111111111111
