1111111111111
1000000000001
1000011110001
100001  10001
10S0011110001
1000000000001
1000000000001
1111111111111
