NO ./img/north1.xpm
SO ./img/south1.xpm
WE ./img/west1.xpm
EA ./img/east1.xpm

F 233,150,122
C 255,228,181

111111111111111111
10000000000000000111
100000111000000000011
100000111000000000001
100000111000000000001
100000111000100000011
10000011100000000011
1000000000000000011
100000000001000001
100000000000000001 1111
100000000N00000001 1101
100000000000000001 1111
111111111111111111