NO ./img/north1.xpm
SO ./img/south1.xpm
WE ./img/west1.xpm
EA ./img/east1.xpm

F 100,255,100
C 225,30,0

111111111111111111
10000000000000000111
100000111000000000011
100000111000000000001
100000111000000000001
100000111000100000011
10000011100000000011
1000000000000000011
100000000001000001
100000000000000001
10000000N000000001
100000000000000001
111111111111111111